1 15 50
2 2 2 2 2 2 2 2 2 2 2 2 2 2 2 2 2 2 2 2 2 2 2 2 2 2 2 2 2 2 2 2 2 2 2 2 2 2 2 2 2 2 2 2 2 2 2 2 2 2
2 0 0 0 0 0 0 0 0 0 0 0 0 0 0 0 0 0 0 0 0 0 0 0 0 0 0 0 0 0 0 0 0 0 0 0 0 0 0 0 0 0 0 0 0 0 0 0 0 2
2 0 0 4 0 0 0 8 7 3 0 3 0 5 0 3 5 3 0 0 0 0 0 0 0 2 0 2 0 2 2 2 0 2 2 2 0 2 2 2 2 2 2 2 2 2 2 2 0 2
2 0 0 6 0 0 0 3 0 3 0 5 0 3 0 3 0 0 0 0 0 0 0 0 0 2 0 2 0 2 0 0 0 0 2 0 0 2 0 0 0 0 0 0 0 0 0 2 0 2
2 0 0 3 0 0 0 8 0 8 0 3 0 3 0 3 3 0 0 0 0 0 0 0 0 2 0 2 0 2 2 0 0 0 2 0 0 2 0 2 2 2 2 3 2 2 0 2 0 2
2 0 0 3 0 0 0 3 0 3 0 3 3 3 0 3 0 0 0 0 0 0 0 0 0 2 0 2 0 2 0 0 0 0 2 0 0 2 0 2 0 0 0 0 0 2 0 2 0 2
2 0 0 3 5 3 0 3 3 3 0 0 3 0 0 3 4 3 0 0 0 0 0 0 0 2 2 2 0 2 2 2 0 0 2 0 0 2 0 2 0 2 2 2 0 2 0 2 0 2
2 0 0 0 0 0 0 0 0 0 0 0 0 0 0 0 0 0 0 0 0 0 0 0 0 0 0 0 0 0 0 0 0 0 0 0 0 2 0 2 0 2 0 2 0 2 0 2 0 2
2 0 0 2 0 2 0 0 2 0 0 2 2 2 0 2 2 2 0 0 0 0 0 0 0 5 5 3 0 3 3 3 0 8 4 3 0 2 0 2 0 2 3 2 0 2 0 2 0 2
2 0 0 2 0 2 0 2 0 2 0 0 2 0 0 2 0 0 0 0 0 0 0 0 0 3 0 3 0 3 0 3 0 3 0 6 0 2 0 2 0 0 0 0 0 2 0 2 0 2
2 0 0 2 2 2 0 2 2 2 0 0 2 0 0 2 2 0 0 0 0 0 0 0 0 4 0 6 0 7 0 7 0 3 3 3 0 2 0 2 2 2 2 2 2 2 0 2 0 2
2 0 0 2 0 2 0 2 0 2 0 0 2 0 0 2 0 0 0 0 0 0 0 0 0 3 0 3 0 3 0 3 0 3 0 0 0 2 0 0 0 0 0 0 0 0 0 2 0 2
2 0 0 2 0 2 0 2 0 2 0 0 2 0 0 2 2 2 0 0 0 0 0 0 0 6 3 3 0 3 3 3 0 4 0 0 0 2 2 2 2 2 2 2 3 2 2 2 0 2
2 0 0 0 0 0 0 0 0 0 0 0 0 0 0 0 0 0 0 0 0 0 0 0 0 0 0 0 0 0 0 0 0 0 0 0 0 0 0 0 0 0 0 0 0 0 0 0 0 2
2 2 2 2 2 2 2 2 2 2 2 2 2 2 2 2 2 2 2 2 2 2 2 2 2 2 2 2 2 2 2 2 2 2 2 2 2 2 2 2 2 2 2 2 2 2 2 2 2 2